# VEHICLES:
ATV = "UTV & ATV"
LCV = "Vans / Light Commercial Vehicles"
FIXEDBODYTRUCKS = "Fixed-body Trucks"
HKLTRUCKS = "Hooklift Trucks"
ARTRUCKS = "SwapBody/AR Trucks"
TRACTORSXS = "Compact / sub-compact Tractors"
TRACTORSXL = "XL / Tracked Tractors"
EXCAVATORS = "Excavators"
CONSTRUCTION = "Construction / Mining"

# TOOLS (IMPLEMENTS & TRAILERS):
HKLTOOLS = "Hooklift Containers"
HKLTRAILERS = "Hooklift Trailers"
ARFRAMES = "SwapBody Superstructures"
ARTRAILERS = "SwapBody Trailers"
SNOWTOOLS = "Snow/Winter"
CRANETOOLS = "Cranes & Transport"
HANDTOOLS = "Hand Tools"
LIQUIDSTRANSPORT = "Liquids Transport"
TANKSHOSES = "Tanks & Hoses"
ATVTRAILERS = "UTV / ATV Trailers"
LIGHTTRAILERS = "Light Trailers"
FLATBEDTRAILERS = "Flatbed/bale Trailers"
LOWLOADERTRAILER = "Equipment Trailers"
LIQUIDSTRAILERS = "Liquids Trailers"
SEMITRAILERS = "Semitrailers"
BULKSEMITRAILERS = "Bulk Semitrailers"
FLATBEDSEMITRAILERS = "Flatbed Semitrailers"
LIQUIDSSEMITRAILERS = "Liquids Semitrailers"
LOWLOADERSEMITRAILERS = "Low Loaders"
EXCAVATORTOOLS = "Excavators & Backhoes"
CONSTRUCTIONTOOLS = "Construction / Mining"

# PLACEABLES:
FACTORIES = "Factories / Production"
REFILLSTATIONS = "Refill stations (buy)"
SELLSTATIONS = "Trade stations (sell)"
RENEWABLEENERGY = "Energy (income)"
BIOMASSENERGY = "Biomass Energy (income)"
SOLARENERGY = "Solar Energy (income)"
WINDENERGY = "Wind Energy (income)"
GREENHOUSES = "Greenhouses & Beehives (income)"
LIQUIDSSTORAGE = "Liquids Storage"
BALESTORAGE = "Bale Storage"
STORAGE = "General Storage"
PALLETSTORAGE = "Shelves & Pallet Storage"
STREETLIGHTSANDSIGNS = "Streetlights & Signs"
COMMUNALBUILDINGS = "Communal Buildings"
PLACEABLETRAFFIC = "Vehicles & Traffic"

# OBJECTS:
IBCPALLETS = "IBC Tanks"
DECORATIVEPALLETS = "Decorative Pallets"
